Key Command List for Extract 3D Photo From Video

H - Show/Remove Keyboard Help Command List
C - Change color of Text and Crosshairs

I - Select input video filename
O - Select output photo folder

Y - Single Mode. Save single frame without a suffix
D - 3D Mode. Save _L and _R frames only
V - 4V Mode. Save suffix _LL _LM _RM _RR frames for LumePad 3D Tablet
T - Lenticular Mode. Save frames with suffix _00 to _09

Space     - Next Video Frame
Backspace - Previous Video Frame

Mouse click sets crosshair at cursor location 
   
G         - Save current crosshair location marking same feature on frames
             Used for setting where the stereo window starts in the frame
Z         - Rewind video
TAB       - Jump 10 frames ahead

L         - Set Frame Type as _L (3D mode) or _LL (4V mode)
M         - Set Frame Type as _LM (4V mode)
N         - Set Frame Type as _RM (4V mode)
R         - Set Frame Type as _R (3D mode) or _RR (4V mode)
0-9       - Set Lenticular Frame Number suffix _00 to _09 (Lenticular mode)

S         - Save Current Display Frame with filename defined by Frame Type
          - Save Frame with suffix _L (3D mode) or _LL (4V mode)
          - Save Frame with suffix _LM (4V mode)
          - Save Frame with suffix _RM (4V mode)
          - Save Frame with suffix _R (3D mode) or _RR (4V mode)
          - Save Frame with suffix _00 to _09 (Lenticular mode)
K         - Save Frame at same resolution as video without offsets
		  
+         - Advance Group filename counter
-         - Reduce Group filename counter

J         - JPG file type output (default)
P         - PNG file type output 
B         - BMP file type output
F         - TIF file type output

For current video frame:
   Left Arrow  - shift display left 1 pixel
   Right Arrow - Shift display right 1 pixel
   Up Arrow    - Shift display up 1 pixel
   Down Arrow  - Shift display down 1 pixel

A         - Toggle showing 3D frames (_L and _R) as Anaglyph
            Toggle showing 4V frames (_LL, _LM, _RM, _RR) as _2x2 quad
X         - Swap Left and Right Images in 3D Anaglyph Display Mode
[         - Reduce crosshair spacing percent of screen width
]         - Increase crosshair spacing percent of screen width

Enter/Play/Pause  Play frames at 5 frames per second